 Afghanistan	AF	AFG	Asia
 Albania	AL	ALB	Europe
 Algeria	DZ	DZA	Africa
 AmericanSamoa	AS	ASM	Australia
 Andorra	AD	AND	Europe
 Angola	AO	AGO	Africa
 Anguilla	AI	AIA	NorthAmerica
 Antarctica	AQ	ATA	Antarctica
 AntiguaAndBarbuda	AG	ATG	NorthAmerica
 Argentina	AR	ARG	SouthAmerica
 Armenia	AM	ARM	Europe
 Aruba	AW	ABW	NorthAmerica
 Australia	AU	AUS	Australia
 Austria	AT	AUT	Europe
 Azerbaijan	AZ	AZE	Europe
 Bahamas	BS	BHS	NorthAmerica
 Bahrain	BH	BHR	Asia
 Bangladesh	BD	BGD	Asia
 Barbados	BB	BRB	NorthAmerica
 Belarus	BY	BLR	Europe
 Belgium	BE	BEL	Europe
 Belize	BZ	BLZ	SouthAmerica
 Benin	BJ	BEN	Africa
 Bermuda	BM	BMU	NorthAmerica
 Bhutan	BT	BTN	Asia
 Bolivia	BO	BOL	SouthAmerica
 BosniaAndHerzegowina	BA	BIH	Europe
 Botswana	BW	BWA	Africa
 BouvetIsland	BV	BVT	None
 Brazil	BR	BRA	SouthAmerica
 BritishIndianOceanTerritory	IO	IOT	Asia
 BruneiDarussalam	BN	BRN	Asia
 Bulgaria	BG	BGR	Europe
 BurkinaFaso	BF	BFA	Africa
 Burundi	BI	BDI	Africa
 Cambodia	KH	KHM	Asia
 Cameroon	CM	CMR	Africa
 Canada	CA	CAN	NorthAmerica
 CapeVerde	CV	CPV	Africa
 CaymanIslands	KY	CYM	NorthAmerica
 CentralAfricanRepublic	CF	CAF	Africa
 Chad	TD	TCD	Africa
 Chile	CL	CHL	SouthAmerica
 China	CN	CHN	Asia
 ChristmasIsland	CX	CXR	Australia
 CocosIslands	CC	CCK	Australia
 Colombia	CO	COL	SouthAmerica
 Comoros	KM	COM	Africa
 DemocraticRepublicOfCongo	CD	COD	Africa
 PeoplesRepublicOfCongo	CG	COG	Africa
 CookIslands	CK	COK	Australia
 CostaRica	CR	CRI	NorthAmerica
 IvoryCoast	CI	CIV	Africa
 Croatia	HR	HRV	Europe
 Cuba	CU	CUB	NorthAmerica
 Cyprus	CY	CYP	Europe
 CzechRepublic	CZ	CZE	Europe
 Denmark	DK	DNK	Europe
 Djibouti	DJ	DJI	Africa
 Dominica	DM	DMA	NorthAmerica
 DominicanRepublic	DO	DOM	NorthAmerica
 EastTimor	TL	TLS	Asia
 Ecuador	EC	ECU	SouthAmerica
 Egypt	EG	EGY	Africa
 ElSalvador	SV	SLV	NorthAmerica
 EquatorialGuinea	GQ	GNQ	Africa
 Eritrea	ER	ERI	Africa
 Estonia	EE	EST	Europe
 Ethiopia	ET	ETH	Africa
 FalklandIslands	FK	FLK	SouthAmerica
 FaroeIslands	FO	FRO	Europe
 Fiji	FJ	FJI	Australia
 Finland	FI	FIN	Europe
 France	FR	FRA	Europe
 MetropolitanFrance	FX	FX.	Europe
 FrenchGuiana	GF	GUF	SouthAmerica
 FrenchPolynesia	PF	PYF	Australia
 FrenchSouthernTerritories	TF	ATF	None
 Gabon	GA	GAB	Africa
 Gambia	GM	GMB	Africa
 Georgia	GE	GEO	Europe
 Germany	DE	DEU	Europe
 Ghana	GH	GHA	Africa
 Gibraltar	GI	GIB	Europe
 Greece	GR	GRC	Europe
 Greenland	GL	GRL	NorthAmerica
 Grenada	GD	GRD	NorthAmerica
 Guadeloupe	GP	GLP	NorthAmerica
 Guam	GU	GUM	Australia
 Guatemala	GT	GTM	NorthAmerica
 Guinea	GN	GIN	Africa
 GuineaBissau	GW	GNB	Africa
 Guyana	GY	GUY	SouthAmerica
 Haiti	HT	HTI	NorthAmerica
 HeardAndMcDonaldIslands	HM	HMD	None
 Honduras	HN	HND	SouthAmerica
 HongKong	HK	HKG	Asia
 Hungary	HU	HUN	Europe
 Iceland	IS	ISL	Europe
 India	IN	IND	Asia
 Indonesia	ID	IDN	Australia
 Iran	IR	IRN	Asia
 Iraq	IQ	IRQ	Asia
 Ireland	IE	IRL	Europe
 Israel	IL	ISR	Asia
 Italy	IT	ITA	Europe
 Jamaica	JM	JAM	NorthAmerica
 Japan	JP	JPN	Asia
 Jordan	JO	JOR	Asia
 Kazakhstan	KZ	KAZ	Europe
 Kenya	KE	KEN	Africa
 Kiribati	KI	KIR	Australia
 DemocraticRepublicOfKorea	KP	PRK	Asia
 RepublicOfKorea	KR	KOR	Asia
 Kuwait	KW	KWT	Asia
 Kyrgyzstan	KG	KGZ	Asia
 Lao	LA	LAO	Asia
 Latvia	LV	LVA	Europe
 Lebanon	LB	LBN	Asia
 Lesotho	LS	LSO	Africa
 Liberia	LR	LBR	Africa
 LibyanArabJamahiriya	LY	LBY	Africa
 Liechtenstein	LI	LIE	Europe
 Lithuania	LT	LTU	Europe
 Luxembourg	LU	LUX	Europe
 Macau	MO	MAC	Asia
 Macedonia	MK	MKD	Europe
 Madagascar	MG	MDG	Africa
 Malawi	MW	MWI	Africa
 Malaysia	MY	MYS	Asia
 Maldives	MV	MDV	Asia
 Mali	ML	MLI	Africa
 Malta	MT	MLT	Europe
 MarshallIslands	MH	MHL	Australia
 Martinique	MQ	MTQ	NorthAmerica
 Mauritania	MR	MRT	Africa
 Mauritius	MU	MUS	Africa
 Mayotte	YT	MYT	Africa
 Mexico	MX	MEX	NorthAmerica
 Micronesia	FM	FSM	Australia
 Moldova	MD	MDA	Asia
 Monaco	MC	MCO	Europe
 Mongolia	MN	MNG	Asia
 Montserrat	MS	MSR	NorthAmerica
 Morocco	MA	MAR	Africa
 Mozambique	MZ	MOZ	Africa
 Myanmar	MM	MMR	Asia
 Namibia	NA	NAM	Africa
 Nauru	NR	NRU	Australia
 Nepal	NP	NPL	Asia
 Netherlands	NL	NLD	Europe
 NetherlandsAntilles	AN	ANT	NorthAmerica
 NewCaledonia	NC	NCL	Australia
 NewZealand	NZ	NZL	Australia
 Nicaragua	NI	NIC	NorthAmerica
 Niger	NE	NER	Africa
 Nigeria	NG	NGA	Africa
 Niue	NU	NIU	Australia
 NorfolkIsland	NF	NFK	Australia
 NorthernMarianaIslands	MP	MNP	Australia
 Norway	NO	NOR	Europe
 Oman	OM	OMN	Asia
 Pakistan	PK	PAK	Asia
 Palau	PW	PLW	Australia
 PalestinianTerritory	PS	PSE	Asia
 Panama	PA	PAN	NorthAmerica
 PapuaNewGuinea	PG	PNG	Australia
 Paraguay	PY	PRY	SouthAmerica
 Peru	PE	PER	SouthAmerica
 Philippines	PH	PHL	Asia
 Pitcairn	PN	PCN	Australia
 Poland	PL	POL	Europe
 Portugal	PT	PRT	Europe
 PuertoRico	PR	PRI	NorthAmerica
 Qatar	QA	QAT	Asia
 Reunion	RE	REU	Africa
 Romania	RO	ROU	Europe
 RussianFederation	RU	RUS	Europe
 Rwanda	RW	RWA	Africa
 SaintKittsAndNevis	KN	KNA	NorthAmerica
 StLucia	LC	LCA	NorthAmerica
 StVincentAndTheGrenadines	VC	VCT	NorthAmerica
 Samoa	WS	WSM	Australia
 SanMarino	SM	SMR	Europe
 SaoTomeAndPrincipe	ST	STP	Africa
 SaudiArabia	SA	SAU	Asia
 Senegal	SN	SEN	Africa
 SerbiaAndMontenegro	CS	SRB	Europe
 Seychelles	SC	SYC	Africa
 SierraLeone	SL	SLE	Africa
 Singapore	SG	SGP	Asia
 Slovakia	SK	SVK	Europe
 Slovenia	SI	SVN	Europe
 SolomonIslands	SB	SLB	Australia
 Somalia	SO	SOM	Africa
 SouthAfrica	ZA	ZAF	Africa
 SouthGeorgiaAndTheSouthSandwichIslands	GS	SGS	SouthAmerica
 Spain	ES	ESP	Europe
 SriLanka	LK	LKA	Asia
 StHelena	SH	SHN	Africa
 StPierreAndMiquelon	PM	SPM	NorthAmerica
 Sudan	SD	SDN	Africa
 Suriname	SR	SUR	SouthAmerica
 SvalbardAndJanMayenIslands	SJ	SJM	Europe
 Swaziland	SZ	SWZ	Africa
 Sweden	SE	SWE	Europe
 Switzerland	CH	CHE	Europe
 SyrianArabRepublic	SY	SYR	Asia
 Taiwan	TW	TWN	Asia
 Tajikistan	TJ	TJK	Asia
 Tanzania	TZ	TZA	Africa
 Thailand	TH	THA	Asia
 Togo	TG	TGO	Africa
 Tokelau	TK	TKL	Australia
 Tonga	TO	TON	Australia
 TrinidadAndTobago	TT	TTO	NorthAmerica
 Tunisia	TN	TUN	Africa
 Turkey	TR	TUR	Europe
 Turkmenistan	TM	TKM	Asia
 TurksAndCaicosIslands	TC	TCA	NorthAmerica
 Tuvalu	TV	TUV	Australia
 Uganda	UG	UGA	Africa
 Ukraine	UA	UKR	Europe
 UnitedArabEmirates	AE	ARE	Asia
 UnitedKingdom	GB	GBR	Europe
 UnitedStates	US	USA	NorthAmerica
 UnitedStatesMinorOutlyingIslands	UM	UMI	Australia
 Uruguay	UY	URY	SouthAmerica
 Uzbekistan	UZ	UZB	Asia
 Vanuatu	VU	VUT	Australia
 VaticanCityState	VA	VAT	Europe
 Venezuela	VE	VEN	SouthAmerica
 VietNam	VN	VNM	Asia
 BritishVirginIslands	VG	VGB	NorthAmerica
 USVirginIslands	VI	VIR	NorthAmerica
 WallisAndFutunaIslands	WF	WLF	Australia
 WesternSahara	EH	ESH	Africa
 Yemen	YE	YEM	Asia
 Yugoslavia	YU	YUG	Europe
 Zambia	ZM	ZMB	Africa
 Zimbabwe	ZW	ZWE	Africa
